000000000000000000000
011111110111011111110
010001010101010100010
011111011101110111110
010001000101000100010
010111111101111111010
010100010000010001010
211111337383933111112
010001030030030100010
010001030333030100010
011111030000030111110
010001033333330100010
033301010000010103330
000301011101110103000
233301110101011103332
010001000101000100010
011111011141110111110
010100010101010001010
010111110111011111010
010000010000010000010
011111111111111111110
000000000000000000000