00000000000000000000000000000000
01111111111111111111111110111110
01111111111111111111111000000010
01111111111111111111111110111110
01111111111111111111111110100000
01111111111000000011111110111110
01111111111111111111111110001000
01111111111111111111111110111010
01111111111111111111111111111010
01100000000111111111111111111010
01111111111111111111111111111110
01111111111111111111111111111110
01111111111111111111111111111110
01111111111111111111111111111110
01111111111111111111111111111110
01111111111111111111111111111110
01111111111111111111111111111110
01111111111111111111011111111110
01111111111111111111011111111110
01111111111111111111000001111110
01111111111111111111111111111110
01111111111111111111111111111110
01111111111111111111111111111110
01111111111111111111111111111110
01111111111111111111111111111110
01111111111111111111111111111110
01111111111111111111111111111110
01111111111111111111111111111110
01111111111111111111111111111110
01111111111111111111111111111110
02111111111111111111111111111110
00000000000000000000000000000000